insert into habilidade_grupo_custo ([id_habilidade],[id_habilidade_grupo]) values ( 3,	1);
insert into habilidade_grupo_custo ([id_habilidade],[id_habilidade_grupo]) values ( 6,	1);
insert into habilidade_grupo_custo ([id_habilidade],[id_habilidade_grupo]) values ( 12,	1);
insert into habilidade_grupo_custo ([id_habilidade],[id_habilidade_grupo]) values ( 29,	1);
insert into habilidade_grupo_custo ([id_habilidade],[id_habilidade_grupo]) values ( 32,	1);
insert into habilidade_grupo_custo ([id_habilidade],[id_habilidade_grupo]) values ( 39,	1);
insert into habilidade_grupo_custo ([id_habilidade],[id_habilidade_grupo]) values ( 40,	1);insert into habilidade_grupo_custo ([id_habilidade],[id_habilidade_grupo]) values ( 1	,2 );
insert into habilidade_grupo_custo ([id_habilidade],[id_habilidade_grupo]) values ( 7	,2 );
insert into habilidade_grupo_custo ([id_habilidade],[id_habilidade_grupo]) values ( 9	,2 );
insert into habilidade_grupo_custo ([id_habilidade],[id_habilidade_grupo]) values ( 11	,2 );
insert into habilidade_grupo_custo ([id_habilidade],[id_habilidade_grupo]) values ( 14	,2 );
insert into habilidade_grupo_custo ([id_habilidade],[id_habilidade_grupo]) values ( 18	,2 );
insert into habilidade_grupo_custo ([id_habilidade],[id_habilidade_grupo]) values ( 19	,2 );insert into habilidade_grupo_custo ([id_habilidade],[id_habilidade_grupo]) values ( 2	,3 );
insert into habilidade_grupo_custo ([id_habilidade],[id_habilidade_grupo]) values ( 4	,3 );
insert into habilidade_grupo_custo ([id_habilidade],[id_habilidade_grupo]) values ( 8	,3 );
insert into habilidade_grupo_custo ([id_habilidade],[id_habilidade_grupo]) values ( 13	,3 );
insert into habilidade_grupo_custo ([id_habilidade],[id_habilidade_grupo]) values ( 23	,3 );
insert into habilidade_grupo_custo ([id_habilidade],[id_habilidade_grupo]) values ( 27	,3 );
insert into habilidade_grupo_custo ([id_habilidade],[id_habilidade_grupo]) values ( 28	,3 );insert into habilidade_grupo_custo ([id_habilidade],[id_habilidade_grupo]) values ( 5	,4 );
insert into habilidade_grupo_custo ([id_habilidade],[id_habilidade_grupo]) values ( 10	,4 );
insert into habilidade_grupo_custo ([id_habilidade],[id_habilidade_grupo]) values ( 16	,4 );
insert into habilidade_grupo_custo ([id_habilidade],[id_habilidade_grupo]) values ( 17	,4 );
insert into habilidade_grupo_custo ([id_habilidade],[id_habilidade_grupo]) values ( 21	,4 );
insert into habilidade_grupo_custo ([id_habilidade],[id_habilidade_grupo]) values ( 31	,4 );
insert into habilidade_grupo_custo ([id_habilidade],[id_habilidade_grupo]) values ( 33	,4 );insert into habilidade_grupo_custo ([id_habilidade],[id_habilidade_grupo]) values ( 15	,5 );
insert into habilidade_grupo_custo ([id_habilidade],[id_habilidade_grupo]) values ( 22	,5 );
insert into habilidade_grupo_custo ([id_habilidade],[id_habilidade_grupo]) values ( 25	,5 );
insert into habilidade_grupo_custo ([id_habilidade],[id_habilidade_grupo]) values ( 26	,5 );
insert into habilidade_grupo_custo ([id_habilidade],[id_habilidade_grupo]) values ( 34	,5 );
insert into habilidade_grupo_custo ([id_habilidade],[id_habilidade_grupo]) values ( 35	,5 );
insert into habilidade_grupo_custo ([id_habilidade],[id_habilidade_grupo]) values ( 42	,5 );insert into habilidade_grupo_custo ([id_habilidade],[id_habilidade_grupo]) values ( 20	,6 );
insert into habilidade_grupo_custo ([id_habilidade],[id_habilidade_grupo]) values ( 24	,6 );
insert into habilidade_grupo_custo ([id_habilidade],[id_habilidade_grupo]) values ( 30	,6 );
insert into habilidade_grupo_custo ([id_habilidade],[id_habilidade_grupo]) values ( 36	,6 );
insert into habilidade_grupo_custo ([id_habilidade],[id_habilidade_grupo]) values ( 37	,6 );
insert into habilidade_grupo_custo ([id_habilidade],[id_habilidade_grupo]) values ( 38	,6 );
insert into habilidade_grupo_custo ([id_habilidade],[id_habilidade_grupo]) values ( 41	,6 );